{
  "Areeiro": [
    2828082,
    2828083,
    2828086,
    2828101,
    2828113,
    2828129,
    2829022,
    2830215,
    2830216
  ],
  "Alameda": [
    2828438,
    2828439,
    2828445,
    2828473,
    2828533,
    2828861,
    2828959,
    2828972,
    2828973,
    2828996,
    2829020,
    2829042,
    2829046,
    2829047
  ]
}